@ . . . . . . . . # . . . . . . . # . . . . . . . # . . . . . . # . . . . . . . # . . . . . . . # . . . . . . . # . . # . . . .
. # . # . # # # . # . # # # # . . # . # . # # # . # . # # # # . . # . # . # # # . # . # # # # . . # . # . # # # . # . # # # # .
. . . # . . . . . # . . . . # . . . . # . . . . . # . . . . # . . . . # . . . . . # . . . . # . . . . # . . . . . # . . . . # .
# # . . . # . # # # . # # . # . # # . . . # . # # # . # # . . . # # . . . # . # # # . # # . # . # # . . . # . # # # . # # . . .
. # # # . # . . . . . . . . # . . # # # . # . . . . . . . . . . . # # # . # . . . . . . . . . . . # # # . # . . . . . . . . . .
. . . . . # . # # # # # # # # # . . . # . # . # # # # . # # # # . . . . . # . # # # # . # # # # . . . . . # . # # # # . # # # #
# # . # . # . # . . . . . . . . # # . # . # . # . . . . . . . . # # . # . # . # . . # . . . . . # # . # . # . # . . . . . . . .
. . . # . . . . . # # # . # # # . . . # . . . . . # # # . # # # . . . # . . . . . # # # . # # # . . . # . . . . . # # # . # # #
. # # # . # # # . . # . . . . # . # # # . # # # . . # . . . . # . # # # . # # # . . # . . . . # . # # # . # # # . . # . . . . #
. . . . . # . . . # # # . # . . . # . . . # . . . # # # . # . . . . . . . # . . . # # # . # . . . . . . . # . . . # # # . # . .
# # # . # # . # . . # . . # # . # # # . # # . # . . # . . # # . # # # # # # . # . . # . . # # . # # # . # # . # . . # . . # # .
. # . . . # . # . # # # . . . . . # . . . # . # . # # # . . . . . # . . . # . # . # # # . . . . . # . . . # . # . # # # . . . .
. # . # . . . # . # . . . # . # . # . # . . . # . . . . . # . # . # . # . . . # . # . . . # . # . # . # . . . # . . . . . # . #
. # . # . # . # . # # # . # . . . # . # . # . # . # # # . # . . . # . # . # . # . # # # . # . . . # . # . # . # . # # # . # . .
. . . # . # # # . # . # # # # # # # . # . # # # . # . # # # # . . # . # . # # # . # . # # # # # # # . # . # # # . # . # # # # .
. # . . . . . . . # . # . . . . . # . . . . . . . # . . . . . . . # . . . . . . . # . # . . . . . # . . . . . . . # . . . . . .
. # . # . # # # # # . # # # # . # # . # # # # # . # . # # # # . . # . # . # # # # # . # # # # . # # . # # # # # . # . # # # # .
. . . # . . . . . # . . . . # . . . . # . . . . . # . . . . # . . . . # . . . . . # . . . . # . . . . # . . . . . # . . . . # .
# # . . . # . # # # . # # . # # # # . . . # . # # # . # # . . . # # . # . # # # # # . # # . # # # # . . . # . # # # . # # . . .
. # # # . # . . . . . . . . . . . # # # . # . . . . . . . . . . . # # # . # . . . . . . # . . . . # # # . # . . . . . . . . . .
. . . . . # . # # # # . # # # # . . . . . # . # # # # . # # # # . . . . . # . # # # # . # # # # . . . . . # . # # # # . # # # #
# # . # . # # # . . . . . . . . # # . # . # . # . . . . . . . . # # . # . # # # . . . . . . . . # # . # . # . # . . . . . . . .
. . . # . . . . . # # # . # # # . . . # . . . . . # # # # # # # . . . # . . . . . # # # . # # # . . . # . . . . . # # # # # # #
. # # # # # # # . . # . . . . # . # # # . # # # . . # . . . . # . # # # # # # # . . # . . . . # . # # # . # # # . . # . . . . #
. . . . . # . . . # # # . # . . . . . . . # . . . # # # . # . . . . . . . # . . . # # # . # . . . . . . . # . . . # # # . # . .
# # # . # # . # . . # . . # # . # # # . # # . # . . # . . # # . # # # # # # . # . . # . . # # . # # # . # # . # . . # . . # # .
. # . . . # . # . # # # . . . . . # . . . # . # . # # # . . . . . # . . . # . # . # # # . . . . . # . . . # . # . # # # . . . .
. # . # . . . # . # . . . # . # . # . # . . . # . . . . . # . # . # . # . # # . . . . . . # . # . # . # . # . # . . . . . # . #
. # . # . # . # . # . # . # . . . # . # . # . # . # . # . # . . . # . # . . # # . # . # . # . . . # . # . # . # . # # . # # # #
. . . # . # # # . # . # . # # # . # . . . # # # . # # # # # # # . . . # . # # . . # . # # # # # . . . # . # # # . # . . # . # .
. # . # . . . . . # . # . # . . . # . # . . . # . . . # . # . . . # . # . . # . # # . . . # . . . # . # . # . . . # . # # . # .
. # . # . # . # . . . # . # . # . # . # . # . # . # . # . # . # . # . # . # # . # . . # . # . # . # . # . # . # . # . # . . # .
. # . . . . . . . # . . . # . . . # . # . . . . . # . . . # . . # . . . . # . . # . . . . . . . # . . . . . . . . . . # . . . .
. # . # . # # # . # . # # # # . . # . # . # # # . # . # # # # . . # . # . # # # . # . # # # # . . # . # . # # # . # . # # # # .
. . . # . . . . . # . . . . # . . . . # . . . . . # . . . . # . . . . # . . . . . # . . . . # . . . . # . . . . . # . . . . # .
# # . . . # . # # # . # # . # . # # . . . # . # # # . # # . . . # # . . . # . # # # . # # . # . # # . . . # . # # # . # # . . .
. # # # . # . . . . . . . . . . . # # # . # . . . . . . . . . . . # # # . # . . . . . . . . . . . # # # . # . . . . . . . . . .
. . . . . # . # # # # . # # # # . . . . . # . # # # # . # # # # . . . . . # . # # # # . # # # # . . . . . # . # # # # . # # # #
# # . # . # . # . . . . . . . . # # . # . # . # . . . . . . . . # # . # . # . # . . . . . . . . # # . # . # . # . . . . . . . .
. . . # . . . . . # # # . # # # . . . # . . . . . # # # . # # # . . . # . . . . . # # # . # # # . . . # . . . . . # # # . # # #
. # # # . # # # . . # . . . . # . # # # . # # # . . # . . . . # . # # # . # # # . . # . . . . # . # # # . # # # . . # . . . . #
. . . . . # . . . # # # . # . . . . . . . # . . . # # # . # . . . . . . . # . . . # # # . # . . . . . . . # . . . # # # . # . .
# # # . # # . # . . # . . # # . # # # . # # . # . . # . . # # # # # # . # # . # . . # . . # # . # # # . # # . # . . # . . # # .
. # . . . # . # . # # # . . . . . # . . . # . # . # # # . . . . . # . . . # . # . # # # . . . . . # . . . # . # . # # # . . . .
. # . # . . . # . . . . . # . # . # . # . . . # . . . . . # . # . # . # . . . # . . . . . # . # . # . # . . . # . . . . . # . #
. # . # . # . # . # # # . # . . . # . # . # . # . # # # . # . # . # . # . # . # . # # # . # . . . # . # . # . # . # # # . # . .
. . . # . # # # . # . # # # # # # # . # . # # # . # . # # # # # . . . # . # # # . # . # # # # # # # . # . # # # . # . # # # # .
. # . . . . . . . # . # . . . . . # . . . . . . . # . . . . . . . # . . . . . . . # . # . . . . . # . . . . . . . # . . . . . .
. # . # . # # # # # . # # # # . # # . # # # # # . # . # # # # . . # . # . # # # # # . # # # # . # # . # # # # # # # . # # # # .
. . . # . . . . . # . . . . # . . . . # . . . . . # . . . . # . . # . # . . . . . # . . . . # . . . . # . . . . . # . . . . # .
# # . . . # . # # # . # # . # # # # . . . # . # # # . # # . # . # # . . . # # # # # . # # . # # # # . . . # . # # # . # # . . .
. # # # . # . . . . . . . . . . . # # # . # . . . . . . . . # . . # # # . # . . . . . . . . . . . # # # . # . . . . . . . . . .
. . . . . # . # # # # . # # # # . . . . . # . # # # # . # # # # . . . . . # . # # # # . # # # # . . . . . # . # # # # . # # # #
# # . # . # # # . . . . . . . . # # . # . # . # . . . . . . . # # # . # . # # # . # . . . . . . # # . # . # . # . . . . . . . .
. . . # . . . . . # # # . # # # . . . # . . . . . # # # # # # # . . . # . . . . . # # # . # # # . . . # . . . . . # # # # # # #
. # # # # # # # . . # . . . . # . # # # . # # # . . # . . . . # . # # # # # # # . . # . . . . # . # # # . # # # . . # . . . . #
. . . . . . . . . # # # . # . . . . . . . # . . . # # # . # . . . . . . . # . . . # # # . # . . . . . . . # . . . # # # . # . .
# # # . # # . # . . # . . # # . # # # . # # . # . . # . . # # . # # # . # # . # . . # . . # # . # # # . # # . # . . # . . # # .
. # . . . # . # . # # # . . . . . # . . . # . # . # # # . . . . . # . . . # . # . # # # . . . . . # . . . # . # . # # # . . . .
. # . # . . . # . # . . . # . # . # . # . . . # . . . . . # . # . # . # . . . # . . . # . # . # . # . # . . . # . . . . . # . #
. # . # . # . # . # . # . # . . . # . # . # . # . # . # . # . . . # . # . # # # . # . # . # . . . # . # . # . # . # # . . # . .
. . . # . # # # . # . # . # # # . # . . . # # # . # # # # # # # . . . # . . # . . # . # # # # # . . . # . # # # . # . . # # # .
. # . # . . . . . # . # . # . . . # . # . . . # . . . # . . . . . # . # . # # . # # . . . # . . . # . # . . . . . # . # # . # .
. # . # . # . # . . . # . . . # . # . # . # . # . # . # . # . # . # . # . . # . # . . # . # . # . # . # . # . # . # . . . . . $