$ # . . . . . .
. # . # . # # #
. . . # . . . .
# # . . . # . #
. # # # . # . .
. . . . . # . #
# # . # . # . #
. . . # . . . @