$ # . . . . . . . # . . . . . .
. # . # . # # # . # . # # # # .
. . . # . . . . . # . . . . # .
# # . . . # . # # # . # # . . .
. # # # . # . . . . . . . . . .
. . . . . # . # # # # . # # # #
# # . # . # . # . . . . . . . .
. . . # . . . . . # # # . # # #
. # # # . # # # . . # . . . . #
. . . . . # . . . # # # . # . .
# # # . # # . # . . # . . # # .
. # . . . # . # . # # # . . . .
. # . # . . . # . . . . . # . #
. # . # . # . # . # . # . # . .
. . . # . # # # . # . # # # # .
. # . # . . . . . # . . . . . @