. # . . . . . . . # . . . . . . . # . . . . . . . # . . . . . . # . . . . . . . # . . . . . . . # . . . . . . . # . . # . . . .
. # . # . # # # . # . # # # # . . # . # . # # # . # . # # # # . . # . # . # # # . # . # # # # . . # . # . # # # . # . # # # # .
. . . # . . . . . # . . . . # . . . . # . . . . . # . . . . # . . . . # . . . . . # . . . . # . . . . # . . . . . # . . . . # .
# # . . . # . # # # . # # . # . # # . . . # . # # # . # # . . . # # . . . # . # # # . # # . # . # # . . . # . # # # . # # . . .
. # # # . # . . . . . . . . . . . # # # . # . . . . . . . . . . . # # # . # . . . . . . . . . . . # # # . # . . . . . @ . . . .
. . . . . # . # # # # . # # # # . . . . . # . # # # # . # # # # . . . . . # . # # # # . # # # # . . . . . # . # # # # . # # # #
# # . # . # . # . . . . . . . . # # . # . # . # . . . . . . . . # # . # . # . # . . . . . . . . # # . # . # . # . . . . . . . .
. . . # . . . . . # # # . # # # . . . # . . . . . # # # . # # # . . . # . . . . . # # # . # # # . . . # . . . . . # # # . # # #
. # # # . # # # . . # . . . . # . # # # . # # # . . # . . . . # . # # # . # # # . . # . . . . # . # # # . # # # . . # . . . . #
. . . . . # . . . # # # . # . . . . . . . # . . . # # # . # . . . . . . . # . . . # # # . # . . . . . . . # . . . # # # . # . .
# # # . # # . # . . # . . # # . # # # . # # . # . . # . . # # . # # # . # # . # . . # . . # # . # # # . # # . # . . # . . # # .
. # . . . # . # . # # # . . . . . # . . . # . # . # # # . . . . . # . . . # . # . # # # . . . . . # . . . # . # . # # # . . . .
. # . # . . . # . . . . . # . # . # . # . . . # . . . . . # . # . # . # . . . # . . . . . # . # . # . # . . . # . . . . . # . #
. # . # . # . # . # # # . # . . . # . # . # . # . # # # . # . . . # . # . # . # . # # # . # . . . # . # . # . # . # # # . # . .
. . . # . # # # . # . # # # # # # # . # . # # # . # . # # # # . . . . # . # # # . # . # # # # # # # . # . # # # . # . # # # # .
. # . . . . . . . # . # . . . . . # . . . . . . . # . . . . . . . # . . . . . . . # . # . . . . . # . . . . . . . # . . . . . .
. # . # . # # # # # . # # # # . # # . # # # # # . # . # # # # . . # . # . # # # # # . # # # # . # # . # # # # # . # . # # # # .
. . . # . . . . . # . . . . # . . . . # . . . . . # . . . . # . . . . # . . . . . # . . . . # . . . . # . . . . . # . . . . # .
# # . . . # . # # # . # # . # # # # . . . # . # # # . # # . . . # # . . . # . # # # . # # . # # # # . . . # . # # # . # # . . .
. # # # . # . . . . . . . . . . . # # # . # . . . . . . . . . . . # # # . # . . . . . . . . . . . # # # . # . . . . . . . . . .
. . . . . # . # # # # . # # # # . . . . . # . # # # # . # # # # . . . . . # . # # # # . # # # # . . . . . # . # # # # . # # # #
# # . # . # # # . . . . . . . . # # . # . # . # . . . . . . . . # # . # . # # # . . . . . . . . # # . # . # . # . . . . . . . .
. . . # . . . . . # # # . # # # . . . # . . . . . # # # # # # # . . . # . . . . . # # # . # # # . . . # . . . . . # # # # # # #
. # # # # # # # . . # . . . . # . # # # . # # # . . # . . . . # . # # # # # # # . . # . . . . # . # # # . # # # . . # . . . . #
. . . . . # . . . # # # . # . . . . . . . # . . . # # # . # . . . . . . . # . . . # # # . # . . . . . . . # . . . # # # . # . .
# # # . # # . # . . # . . # # . # # # . # # . # . . # . . # # . # # # . # # . # . . # . . # # . # # # . # # . # . . # . . # # .
. # . . . # . # . # # # . . . . . # . . . # . # . # # # . . . . . # . . . # . # . # # # . . . . . # . . . # . # . # # # . . . .
. # . # . . . # . # . . . # . # . # . # . . . # . . . . . # . # . # . # . # # . . . . . . # . # . # . # . . . # . . . . . # . #
. # . # . # . # . # . # . # . . . # . # . # . # . # . # . # . . . # . # . . # # . # . # . # . . . # . # . # . # . # # . # # # #
. . . # . # # # . # . # . # # # . # . . . # # # . # # # # # # # . . . # . # # . . # . # # # # # . . . # . # # # . # . . # . # .
. # . # . . . . . # . # . # . . . # . # . . . # . . . # . # . . . # . # . . # . # # . . . # . . . # . # . . . . . # . # # . # .
. # . # . # . # . . . # . # . # . # . # . # . # . # . # . # . # . # . # . # # . # . . # . # . # . # . # . # . # . # . . . . # .
. # . . . . . . . # . . . # . . . # . # . . . . . # . . . # . . # . . . . # . . # . . . . . . . # . . . . . . . # . . # . . . .
. # . # . # # # . # . # # # # . . # . # . # # # . # . # # # # . . # . # . # # # . # . # # # # . . # . # . # # # . # . # # # # .
. . . # . . . . . # . . . . # . . . . # . . . . . # . . . . # . . . . # . . . . . # . . . . # . . . . # . . . . . # . . . . # .
# # . . . # . # # # . # # . # . # # . . . # . # # # . # # . . . # # . . . # . # # # . # # . # . # # . . . # . # # # . # # . . .
. # # # . # . . . . . . . . . . . # # # . # . . . . . . . . . . . # # # . # . . . . . . . . . . . # # # . # . . . . . . . . . .
. . . . . # . # # # # . # # # # . . . . . # . # # # # . # # # # . . . . . # . # # # # . # # # # . . . . . # . # # # # . # # # #
# # . # . # . # . . . . . . . . # # . # . # . # . . . . . . . . # # . # . # . # . . . . . . . . # # . # . # . # . . . . . . . .
. . . # . . . . . # # # . # # # . . . # . . . . . # # # . # # # . . . # . . . . . # # # . # # # . . . # . . . . . # # # . # # #
. # # # . # # # . . # . . . . # . # # # . # # # . . # . . . . # . # # # . # # # . . # . . . . # . # # # . # # # . . # . . . . #
. . . . . # . . . # # # . # . . . . . . . # . . . # # # . # . . . . . . . # . . . # # # . # . . . . . . . # . . . # # # . # . .
# # # . # # . # . . # . . # # . # # # . # # . # . . # . . # # . # # # . # # . # . . # . . # # . # # # . # # . # . . # . . # # .
. # . . . # . # . # # # . . . . . # . . . # . # . # # # . . . . . # . . . # . # . # # # . . . . . # . . . # . # . # # # . . . .
. # . # . . . # . . . . . # . # . # . # . . . # . . . . . # . # . # . # . . . # . . . . . # . # . # . # . . . # . . . . . # . #
. # . # . # . # . # # # . # . . . # . # . # . # . # # # . # . . . # . # . # . # . # # # . # . . . # . # . # . # . # # # . # . .
. . . # . # # # . # . # # # # # # # . # . # # # . # . # # # # . . . . # . # # # . # . # # # # # # # . # . # # # . # . # # # # .
. # . . . . . . . # . # . . . . . # . . . . . . . # . . . . . . . # . . . . . . . # . # . . . . . # . . . . . . . # . . . . . .
. # . # . # # # # # . # # # # . # # . # # # # # . # . # # # # . . # . # . # # # # # . # # # # . # # . # # # # # . # . # # # # .
. . . # . . . . . # . . . . # . . . . # . . . . . # . . . . # . . . . # . . . . . # . . . . # . . . . # . . . . . # . . . . # .
# # . . . # . # # # . # # . # # # # . . . # . # # # . # # . . . # # . . . # . # # # . # # . # # # # . . . # . # # # . # # . . .
. # # # . # . . . . . . . . . . . # # # . # . . . . . . . . . . . # # # . # . . . . . . . . . . . # # # . # . . . . . . . . . .
. . . . . # . # # # # . # # # # . . . . . # . # # # # . # # # # . . . . . # . # # # # . # # # # . . . . . # . # # # # . # # # #
# # . # . # # # . . . . . . . . # # . # . # . # . . . . . . . . # # . # . # # # . . . . . . . . # # . # . # . # . . . . . . . .
. . . # . . . . . # # # . # # # . . . # . . . . . # # # # # # # . . . # . . . . . # # # . # # # . . . # . . . . . # # # # # # #
. # # # # # # # . . # . . . . # . # # # . # # # . . # . . . . # . # # # # # # # . . # . . . . # . # # # . # # # . . # . . . . #
. . . . . # . . . # # # . # . . . . . . . # . . . # # # . # . . . . . . . # . . . # # # . # . . . . . . . # . . . # # # . # . .
# # # . # # . # . . # . . # # . # # # . # # . # . . # . . # # . # # # . # # . # . . # . . # # . # # # . # # . # . . # . . # # .
. # . . . # . # . # # # . . . . . # . . . # . # . # # # . . . . . # . . . # . # . # # # . . . . . # . . . # . # . # # # . . . .
. # . # . . . # . # . . . # . # . # . # . . . # . . . . . # . # . # . # . . . # . . . . . # . # . # . # . . . # . . . . . # . #
. # . # . # . # . # . # . # . . . # . # . # . # . # . # . # . . . # . # . # # # . # . # . # . . . # . # . # . # . # # . . # . .
. . . # . # # # . # . # . # # # . # . . . # # # . # # # # # # # . . . # . . # . . # . # # # # # . . . # . # # # . # . . # # # .
. # . # . . . . . # . # . # . . . # . # . . . # . . . # . . . . . # . # . # # . # # . . . # . . . # . # . . . . . # . # # . # .
. # $ # . # . # . . . # . . . # . # . # . # . # . # . # . # . # . # . # . . # . # . . # . # . # . # . # . # . # . # . . . . # .