@ . . . . . . . . # . . . . . . . # . . . . . . . # . . . . . . # . . . . . . . # . . . . . . . # . . . . . . . # . . # . . . . 
* # . # . # # # . # . # # # # . . # . # . # # # . # . # # # # . . # . # . # # # . # . # # # # . . # . # . # # # . # . # # # # . 
* * * # . . . . . # . . . . # . . . . # . . . . . # . . . . # . . . . # . . . . . # . . . . # . . . . # . . . . . # . . . . # . 
# # * * * # . # # # . # # . # . # # . . . # . # # # . # # . . . # # . . . # . # # # . # # . # . # # . . . # . # # # . # # . . . 
. # # # * # . . . . . . . . # . . # # # . # . . . . . . . . . . . # # # . # . . . . . . . . . . . # # # . # . . . . . . . . . . 
. . . . * # . # # # # # # # # # . . . # . # . # # # # . # # # # . . . . . # . # # # # . # # # # . . . . . # . # # # # . # # # # 
# # . # * # . # . . . . . . . . # # . # . # . # . . . . . . . . # # . # . # . # . . # . . . . . # # . # . # . # . . . . . . . . 
. . . # * . . . . # # # . # # # . . . # . . . . . # # # . # # # . . . # . . . . . # # # . # # # . . . # . . . . . # # # . # # # 
. # # # * # # # . . # . . . . # . # # # . # # # . . # . . . . # . # # # . # # # . . # . . . . # . # # # . # # # . . # . . . . # 
. . . * * # . . . # # # . # . . . # . . . # . . . # # # . # . . . . . . . # . . . # # # . # . . . . . . . # . . . # # # . # . . 
# # # * # # . # . . # . . # # . # # # . # # . # . . # . . # # . # # # # # # . # . . # . . # # . # # # . # # . # . . # . . # # . 
. # . * * # . # . # # # . . . . . # . . . # . # . # # # . . . . . # . . . # . # . # # # . . . . . # . . . # . # . # # # . . . . 
. # . # * . . # . # . . . # . # . # . # . . . # . . . . . # . # . # . # . . . # . # . . . # . # . # . # . . . # . . . . . # . # 
. # . # * # . # . # # # . # . . . # . # . # . # . # # # . # . . . # . # . # . # . # # # . # . . . # . # . # . # . # # # . # . . 
. . . # * # # # . # . # # # # # # # . # . # # # . # . # # # # . . # . # . # # # . # . # # # # # # # . # . # # # . # . # # # # . 
. # . . * . . . . # . # . . . . . # . . . . . . . # . . . . . . . # . . . . . . . # . # . . . . . # . . . . . . . # . . . . . . 
. # . # * # # # # # . # # # # . # # . # # # # # . # . # # # # . . # . # . # # # # # . # # # # . # # . # # # # # . # . # # # # . 
. . . # * * * . . # . . . . # . . . . # . . . . . # . . . . # . . . . # . . . . . # . . . . # . . . . # . . . . . # . . . . # . 
# # . . . # * # # # . # # . # # # # . . . # . # # # . # # . . . # # . # . # # # # # . # # . # # # # . . . # . # # # . # # . . . 
. # # # . # * * * * * * . . . . . # # # . # . . . . . . . . . . . # # # . # . . . . . . # . . . . # # # . # . . . . . . . . . . 
. . . . . # . # # # # * # # # # . . . . . # . # # # # . # # # # . . . . . # . # # # # . # # # # . . . . . # . # # # # . # # # # 
# # . # . # # # . . . * * . . . # # . # . # . # . . . . . . . . # # . # . # # # . . . . . . . . # # . # . # . # . . . . . . . . 
. . . # . . . . . # # # * # # # . . . # . . . . . # # # # # # # . . . # . . . . . # # # . # # # . . . # . . . . . # # # # # # # 
. # # # # # # # . . # . * * * # . # # # . # # # . . # . . . . # . # # # # # # # . . # . . . . # . # # # . # # # . . # . . . . # 
. . . . . # . . . # # # . # * * * * * * . # . . . # # # . # . . . . . . . # . . . # # # . # . . . . . . . # . . . # # # . # . . 
# # # . # # . # . . # . . # # . # # # * # # . # . . # . . # # . # # # # # # . # . . # . . # # . # # # . # # . # . . # . . # # . 
. # . . . # . # . # # # . . . . . # . * * # . # . # # # . . . . . # . . . # . # . # # # . . . . . # . . . # . # . # # # . . . . 
. # . # . . . # . # . . . # . # . # . # * . . # . . . . . # . # . # . # . # # . . . . . . # . # . # . # . # . # . . . . . # . # 
. # . # . # . # . # . # . # . . . # . # * # . # . # . # . # . . . # . # . . # # . # . # . # . . . # . # . # . # . # # . # # # # 
. . . # . # # # . # . # . # # # . # . . * # # # . # # # # # # # . . . # . # # . . # . # # # # # . . . # . # # # . # . . # . # . 
. # . # . . . . . # . # . # . . . # . # * . . # . . . # . # . . . # . # . . # . # # . . . # . . . # . # . # . . . # . # # . # . 
. # . # . # . # . . . # . # . # . # . # * # . # . # . # . # . # . # . # . # # . # . . # . # . # . # . # . # . # . # . # . . # . 
. # . . . . . . . # . . . # . . . # . # * . . . . # . . . # . . # . . . . # . . # . . . . . . . # . . . . . . . . . . # . . . . 
. # . # . # # # . # . # # # # . . # . # * # # # . # . # # # # . . # . # . # # # . # . # # # # . . # . # . # # # . # . # # # # . 
. . . # . . . . . # . . . . # . . . . # * * * . . # . . . . # . . . . # . . . . . # . . . . # . . . . # . . . . . # . . . . # . 
# # . . . # . # # # . # # . # . # # . . . # * # # # . # # . . . # # . . . # . # # # . # # . # . # # . . . # . # # # . # # . . . 
. # # # . # . . . . . . . . . . . # # # . # * * * * * * * * * * * # # # . # . . . . . . . . . . . # # # . # . . . . . . . . . . 
. . . . . # . # # # # . # # # # . . . . . # . # # # # . # # # # * * * * * # . # # # # . # # # # . . . . . # . # # # # . # # # # 
# # . # . # . # . . . . . . . . # # . # . # . # . . . . . . . . # # . # * # . # * * * * * . . . # # . # . # . # . . . . . . . . 
. . . # . . . . . # # # . # # # . . . # . . . . . # # # . # # # . . . # * * * * * # # # * # # # . . . # . . . . . # # # . # # # 
. # # # . # # # . . # . . . . # . # # # . # # # . . # . . . . # . # # # . # # # . . # . * * * # . # # # . # # # . . # . . . . # 
. . . . . # . . . # # # . # . . . . . . . # . . . # # # . # . . . . . . . # . . . # # # . # * * * * * * . # . . . # # # . # . . 
# # # . # # . # . . # . . # # . # # # . # # . # . . # . . # # # # # # . # # . # . . # . . # # . # # # * # # . # . . # . . # # . 
. # . . . # . # . # # # . . . . . # . . . # . # . # # # . . . . . # . . . # . # . # # # . . . . . # * * . # . # . # # # . . . . 
. # . # . . . # . . . . . # . # . # . # . . . # . . . . . # . # . # . # . . . # . . . . . # . # . # * # . . . # . . . . . # . # 
. # . # . # . # . # # # . # . . . # . # . # . # . # # # . # . # . # . # . # . # . # # # . # . . . # * # . # . # . # # # . # . . 
. . . # . # # # . # . # # # # # # # . # . # # # . # . # # # # # . . . # . # # # . # . # # # # # # # * # . # # # . # . # # # # . 
. # . . . . . . . # . # . . . . . # . . . . . . . # . . . . . . . # . . . . . . . # . # . . . . . # * . . . . . . # . . . . . . 
. # . # . # # # # # . # # # # . # # . # # # # # . # . # # # # . . # . # . # # # # # . # # # # . # # * # # # # # # # . # # # # . 
. . . # . . . . . # . . . . # . . . . # . . . . . # . . . . # . . # . # . . . . . # . . . . # . . . * # . . . . . # . . . . # . 
# # . . . # . # # # . # # . # # # # . . . # . # # # . # # . # . # # . . . # # # # # . # # . # # # # * * * # . # # # . # # . . . 
. # # # . # . . . . . . . . . . . # # # . # . . . . . . . . # . . # # # . # . . . . . . . . . . . # # # * # . . . . . . . . . . 
. . . . . # . # # # # . # # # # . . . . . # . # # # # . # # # # . . . . . # . # # # # . # # # # . . . . * # . # # # # . # # # # 
# # . # . # # # . . . . . . . . # # . # . # . # . . . . . . . # # # . # . # # # . # . . . . . . # # . # * # . # . . . . . . . . 
. . . # . . . . . # # # . # # # . . . # . . . . . # # # # # # # . . . # . . . . . # # # . # # # . . . # * * * * * # # # # # # # 
. # # # # # # # . . # . . . . # . # # # . # # # . . # . . . . # . # # # # # # # . . # . . . . # . # # # . # # # * . # . . . . # 
. . . . . . . . . # # # . # . . . . . . . # . . . # # # . # . . . . . . . # . . . # # # . # . . . . . . . # . . * # # # . # . . 
# # # . # # . # . . # . . # # . # # # . # # . # . . # . . # # . # # # . # # . # . . # . . # # . # # # . # # . # * . # . . # # . 
. # . . . # . # . # # # . . . . . # . . . # . # . # # # . . . . . # . . . # . # . # # # . . . . . # . . . # . # * # # # . . . . 
. # . # . . . # . # . . . # . # . # . # . . . # . . . . . # . # . # . # . . . # . . . # . # . # . # . # . . . # * * * * . # . # 
. # . # . # . # . # . # . # . . . # . # . # . # . # . # . # . . . # . # . # # # . # . # . # . . . # . # . # . # . # # * . # . . 
. . . # . # # # . # . # . # # # . # . . . # # # . # # # # # # # . . . # . . # . . # . # # # # # . . . # . # # # . # * * # # # . 
. # . # . . . . . # . # . # . . . # . # . . . # . . . # . . . . . # . # . # # . # # . . . # . . . # . # . . . . . # * # # . # . 
. # . # . # . # . . . # . . . # . # . # . # . # . # . # . # . # . # . # . . # . # . . # . # . # . # . # . # . # . # * * * * * $ 
