$ . . . . . . . . . . . . . . . 
* . . . . . . . . . . . . . . . 
* . . . . . . . . . . . . . . . 
* . . . . . . . . . . . . . . . 
* . . . . . . . . . . . . . . . 
* . . . . . . . . . . . . . . . 
* . . . . . . . . . . . . . . . 
* . . . . . . . . . . . . . . . 
* . . . . . . . . . . . . . . . 
* . . . . . . . . . . . . . . . 
* . . . . . . . . . . . . . . . 
* . . . . . . . . . . . . . . . 
* . . . . . . . . . . . . . . . 
* . . . . . . . . . . . . . . . 
* . . . . . . . . . . . . . . . 
* * * * * * * * * * * * * * * @ 
