$ # . . . . . . 
* # . # . # # # 
* * * # . . . . 
# # * * * # . # 
. # # # * # . . 
. . . . * # . # 
# # . # * # . # 
. . . # * * * @ 
