. # . . . . . . . # . . . . . . . # . . . . . . . # . . . . . . # . . . . . . . # . . . . . . . # . . . . . . . # . . # . . . . 
. # . # . # # # . # . # # # # . . # . # . # # # . # . # # # # . . # . # . # # # . # . # # # # . . # . # . # # # . # . # # # # . 
. . . # . . . . . # . . . . # . . . . # . . . . . # . . . . # . . . . # . . . . . # . . . . # . . . . # . . . . . # . . . . # . 
# # . . . # . # # # . # # . # . # # . . . # . # # # . # # . . . # # . . . # . # # # . # # . # . # # . . . # . # # # . # # . . . 
. # # # . # . . . . . . . . . . . # # # . # . . . . . . . . . . . # # # . # . . . . . . . . . . . # # # . # . . . . . @ . . . . 
. . . . . # . # # # # . # # # # . . . . . # . # # # # . # # # # . . . . . # . # # # # . # # # # . . . . . # . # # # # * # # # # 
# # . # . # . # . . . . . . . . # # . # . # . # . . . . . . . . # # . # . # . # . . . . . . . . # # . # . # . # * * * * . . . . 
. . . # . . . . . # # # . # # # . . . # . . . . . # # # . # # # . . . # . . . . . # # # . # # # . . . # . . . . * # # # . # # # 
. # # # . # # # . . # . . . . # . # # # . # # # . . # . . . . # . # # # . # # # . . # . . . . # . # # # . # # # * . # . . . . # 
. . . . . # . . . # # # . # . . . . . . . # . . . # # # . # . . . . . . . # . . . # # # . # . . . . . . . # . . * # # # . # . . 
# # # . # # . # . . # . . # # . # # # . # # . # . . # . . # # . # # # . # # . # . . # . . # # . # # # . # # . # * . # . . # # . 
. # . . . # . # . # # # . . . . . # . . . # . # . # # # . . . . . # . . . # . # . # # # . . . . . # . . . # . # * # # # . . . . 
. # . # . . . # . . . . . # . # . # . # . . . # . . . . . # . # . # . # . . . # . . . . . # . # . # . # . . . # * . . . . # . # 
. # . # . # . # . # # # . # . . . # . # . # . # . # # # . # . . . # . # . # . # . # # # . # . . . # . # . # . # * # # # . # . . 
. . . # . # # # . # . # # # # # # # . # . # # # . # . # # # # . . . . # . # # # . # . # # # # # # # . # . # # # * # . # # # # . 
. # . . . . . . . # . # . . . . . # . . . . . . . # . . . . . . . # . . . . . . . # . # . . . . . # . . . . . . * # . . . . . . 
. # . # . # # # # # . # # # # . # # . # # # # # . # . # # # # . . # . # . # # # # # . # # # # . # # . # # # # # * # . # # # # . 
. . . # . . . . . # . . . . # . . . . # . . . . . # . . . . # . . . . # . . . . . # . . . . # . . . . # * * * * * # . . . . # . 
# # . . . # . # # # . # # . # # # # . . . # . # # # . # # . . . # # . . . # . # # # . # # . # # # # . . * # . # # # . # # . . . 
. # # # . # . . . . . . . . . . . # # # . # . . . . . . . . . . . # # # . # . . . . . . . . . . . # # # * # . . . . . . . . . . 
. . . . . # . # # # # . # # # # . . . . . # . # # # # . # # # # . . . . . # . # # # # . # # # # . . * * * # . # # # # . # # # # 
# # . # . # # # . . . . . . . . # # . # . # . # . . . . . . . . # # . # . # # # . . . . . . . . # # * # . # . # . . . . . . . . 
. . . # . . . . . # # # . # # # . . . # . . . . . # # # # # # # . . . # . . . . . # # # . # # # * * * # . . . . . # # # # # # # 
. # # # # # # # . . # . . . . # . # # # . # # # . . # . . . . # . # # # # # # # . . # . . . . # * # # # . # # # . . # . . . . # 
. . . . . # . . . # # # . # . . . . . . . # . . . # # # . # . . . . . . . # . . . # # # . # . * * . . . . # . . . # # # . # . . 
# # # . # # . # . . # . . # # . # # # . # # . # . . # . . # # . # # # . # # . # . . # . . # # * # # # . # # . # . . # . . # # . 
. # . . . # . # . # # # . . . . . # . . . # . # . # # # . . . . . # . . . # . # . # # # * * * * . # . . . # . # . # # # . . . . 
. # . # . . . # . # . . . # . # . # . # . . . # . . . . . # . # . # . # . # # . . . * * * # . # . # . # . . . # . . . . . # . # 
. # . # . # . # . # . # . # . . . # . # . # . # . # . # . # . . . # . # . . # # . # * # . # . . . # . # . # . # . # # . # # # # 
. . . # . # # # . # . # . # # # . # . . . # # # . # # # # # # # . . . # . # # . . # * # # # # # . . . # . # # # . # . . # . # . 
. # . # . . . . . # . # . # . . . # . # . . . # . . . # . # . . . # . # . . # . # # * . . # . . . # . # . . . . . # . # # . # . 
. # . # . # . # . . . # . # . # . # . # . # . # . # . # . # . # . # . # . # # . # . * # . # . # . # . # . # . # . # . . . . # . 
. # . . . . . . . # . . . # . . . # . # . . . . . # . . . # . . # . . . . # . . # . * . . . . . # . . . . . . . # . . # . . . . 
. # . # . # # # . # . # # # # . . # . # . # # # . # . # # # # . . # . # . # # # . # * # # # # . . # . # . # # # . # . # # # # . 
. . . # . . . . . # . . . . # . . . . # . . . . . # . . . . # . . . . # . . . . . # * . . . # . . . . # . . . . . # . . . . # . 
# # . . . # . # # # . # # . # . # # . . . # . # # # . # # . . . # # . . . # . # # # * # # . # . # # . . . # . # # # . # # . . . 
. # # # . # . . . . . . . . . . . # # # . # . . . . . . . . . . . # # # . # * * * * * . . . . . . # # # . # . . . . . . . . . . 
. . . . . # . # # # # . # # # # . . . . . # . # # # # . # # # # . . . . . # * # # # # . # # # # . . . . . # . # # # # . # # # # 
# # . # . # . # . . . . . . . . # # . # . # . # . . . . . . . . # # . # . # * # . . . . . . . . # # . # . # . # . . . . . . . . 
. . . # . . . . . # # # . # # # . . . # . . . . . # # # . # # # . . . # * * * . . # # # . # # # . . . # . . . . . # # # . # # # 
. # # # . # # # . . # . . . . # . # # # . # # # . . # . . . . # . # # # * # # # . . # . . . . # . # # # . # # # . . # . . . . # 
. . . . . # . . . # # # . # . . . . . . . # . . . # # # . # . * * * * * * # . . . # # # . # . . . . . . . # . . . # # # . # . . 
# # # . # # . # . . # . . # # . # # # . # # . # . . # . . # # * # # # . # # . # . . # . . # # . # # # . # # . # . . # . . # # . 
. # . . . # . # . # # # . . . . . # . . . # . # . # # # * * * * . # . . . # . # . # # # . . . . . # . . . # . # . # # # . . . . 
. # . # . . . # . . . . . # . # . # . # . . . # * * * * * # . # . # . # . . . # . . . . . # . # . # . # . . . # . . . . . # . # 
. # . # . # . # . # # # . # . . . # . # . # . # * # # # . # . . . # . # . # . # . # # # . # . . . # . # . # . # . # # # . # . . 
. . . # . # # # . # . # # # # # # # . # . # # # * # . # # # # . . . . # . # # # . # . # # # # # # # . # . # # # . # . # # # # . 
. # . . . . . . . # . # . . . . . # . . . . . . * # . . . . . . . # . . . . . . . # . # . . . . . # . . . . . . . # . . . . . . 
. # . # . # # # # # . # # # # . # # . # # # # # * # . # # # # . . # . # . # # # # # . # # # # . # # . # # # # # . # . # # # # . 
. . . # . . . . . # . . . . # . . . . # * * * * * # . . . . # . . . . # . . . . . # . . . . # . . . . # . . . . . # . . . . # . 
# # . . . # . # # # . # # . # # # # . . * # . # # # . # # . . . # # . . . # . # # # . # # . # # # # . . . # . # # # . # # . . . 
. # # # . # . . . . . * * * * * * # # # * # . . . . . . . . . . . # # # . # . . . . . . . . . . . # # # . # . . . . . . . . . . 
. . . . . # . # # # # * # # # # * * * * * # . # # # # . # # # # . . . . . # . # # # # . # # # # . . . . . # . # # # # . # # # # 
# # . # . # # # * * * * . . . . # # . # . # . # . . . . . . . . # # . # . # # # . . . . . . . . # # . # . # . # . . . . . . . . 
. . . # . . . . * # # # . # # # . . . # . . . . . # # # # # # # . . . # . . . . . # # # . # # # . . . # . . . . . # # # # # # # 
. # # # # # # # * . # . . . . # . # # # . # # # . . # . . . . # . # # # # # # # . . # . . . . # . # # # . # # # . . # . . . . # 
. . . . . # * * * # # # . # . . . . . . . # . . . # # # . # . . . . . . . # . . . # # # . # . . . . . . . # . . . # # # . # . . 
# # # . # # * # . . # . . # # . # # # . # # . # . . # . . # # . # # # . # # . # . . # . . # # . # # # . # # . # . . # . . # # . 
. # * * * # * # . # # # . . . . . # . . . # . # . # # # . . . . . # . . . # . # . # # # . . . . . # . . . # . # . # # # . . . . 
. # * # * * * # . # . . . # . # . # . # . . . # . . . . . # . # . # . # . . . # . . . . . # . # . # . # . . . # . . . . . # . # 
. # * # . # . # . # . # . # . . . # . # . # . # . # . # . # . . . # . # . # # # . # . # . # . . . # . # . # . # . # # . . # . . 
. . * # . # # # . # . # . # # # . # . . . # # # . # # # # # # # . . . # . . # . . # . # # # # # . . . # . # # # . # . . # # # . 
. # * # . . . . . # . # . # . . . # . # . . . # . . . # . . . . . # . # . # # . # # . . . # . . . # . # . . . . . # . # # . # . 
. # $ # . # . # . . . # . . . # . # . # . # . # . # . # . # . # . # . # . . # . # . . # . # . # . # . # . # . # . # . . . . # . 
