$ # . . . . . . . # . . . . . . 
* # . # . # # # . # . # # # # . 
* * * # . . . . . # . . . . # . 
# # * * * # . # # # . # # . . . 
. # # # * # . . . . . . . . . . 
. . . . * # . # # # # . # # # # 
# # . # * # . # . . . . . . . . 
. . . # * * * * * # # # . # # # 
. # # # . # # # * . # . . . . # 
. . . . . # . . * # # # . # . . 
# # # . # # . # * . # . . # # . 
. # . . . # . # * # # # . . . . 
. # . # . . . # * * * . . # . # 
. # . # . # . # . # * # . # . . 
. . . # . # # # . # * # # # # . 
. # . # . . . . . # * * * * * @ 
